F       42, 10,   1          
NO textures/woodBrick.xpm    
EA textures/bookShelf.xpm           

WE textures/blueGrey.xpm
C 30,30,30
SO textures/multiBrick.xpm

111111111111111111
100000100001100001
100000100000000001
1000000000000000N1     
100000100001100011
100000110111111111
111011110111111111
111111110111111111
111111000001
     1000001
     1000001
     1000001
     1111111

