F 30,30,30
NO textures/woodBrick.xpm
EA textures/bookShelf.xpm
SO textures/multiBrick.xpm
WE textures/blueGrey.xpm
C 0,30,30



111111111111111111
100000100001100001
100000100000000001
100000000000000N01
100000100001100001
100000111111111111
111011111111111111
111111111111111111